[level]
tileset = ground.png
tile_height = 16
tile_width = 24
map = .........................
      .#####.##...##...........
      .#...#..#................
      .#..b####.......b........
      .##.##.......##..........
      .............#...........
      ............#............
      ...........#............#
      ...b....................#
      ........................#
      ........................#
      ....................#####

[.]
name = floor
tile = 0, 3

[#]
name = wall
wall = true
block = true

[x]
name = chest
tile = 0, 3
block = true
sprite = Assets/Dungeon Crawl Stone Soup Full/dungeon/chest.png